NO ./texture/wood0.xpm
SO ./texture/wood1.xpm
WE ./texture/wood2.xpm
EA ./texture/wood3.xpm

F 81,41,28
C 53,168,230

        1111111111111111111111111
        100100000110000000000001
        101111110000000001000001
        1001110100000000N00000001
111111111011000001110000000000001
100000011111000001110111111111111
1111011111111011100000010001
11110111111110011101010010001
11000000111110011100000010001
1000000000000001100000010001
10000000000000001101010010001
110000011101010111110111100111
11110111 1110101 101111010001
11111111 1111111 111111111111