NO ./texture/wood0.xpm
SO ./texture/wood1.xpm
WE ./texture/wood2.xpm
EA ./texture/wood3.xpm

F 81,41,28
C 53,168,230

11111111111111111111111111111111111111
11111111111111111111111111111100011111
11111111111111111111111111111100011111
11111111111111111111111111111100011111
11111111111111111111111111111100011111
11111111111111111111111111111100011111
11111111111111111111111111111100011111
100000000000000N0000000000000000000001
10000000000000000000000000000000000001
10001111111111111111111111111111111111
10001111111111111111111111111111111111
10001111111111111111111111111111111111
10000000000000000001111111111111111111
10000000000000000001111111111111111111
11111111111111110001111111111111111111
11111111111111111111111111111111111111
