111111111111111111111111111
100000000000000000000000001
100C00000C000P000000CC00001
10000000000M000000000000001
1000000M000000000000M000001
1000000000C00000C00000C0001
1000M0000000000000000000001
100000000000000000000C00001
100E00000000000000000000001
111111111111111111111111111
