11111111111111111111111111111111111111111111111
1111111111C0110M010C01CM0000MC1MC000111100C00M1
1E00CC000010000C000M0001C010001000100C0000100P1
1111111110001100M00111000000M00000C1111C00101C1
11111111111111111111111111111111111111111111111
