1111111111111111111111111111111111
100000000C000000000000000000C00001
1000000000000000000000000M00000001
10E0000000000000000000000000M00001
100C000P0000M000001111111111111111
1M0000000M000000001M000M000M000M01
10000M000M00C0000010M0M00M000M0001
1C000000M0000C00000000000M000000C1
1111111111111111111111111111111111
